nauf: faun; 
sorck: rocks; corks; 
foclaa: afocal; 
umecry: yercum; 
ailucn: alcuin; lucian; lucina; uncial; cunila; 
oaymcth: tomchay; 
unoinrg: grunion; 
oloyarg: oralogy; 
umcks: mucks; 
uleym: muley; 
ljaeh: jahel; 
yjoek: jokey; 
lpswe: plews; swelp; 
amldy: madly; 
sndot: stond; 
ujebse: subjee; 
ebayrm: ambery; mabyer; 
naldsu: landus; suldan; 
yliwght: wightly; 
perogadb: pegboard; 
ncifdnoe: confined; 
issndere: direness; 
vruntul: vulturn; 
ooamcch: camooch; 
tlycade: decatyl; 
onctnaia: catonian; taconian; 
ainmsce: amnesic; cinemas; emiscan; 
orslu: slour; lorus; lours; 
eunlubca: nubecula; 
ogermkcla: clogmaker; 
imuslelk: slumlike; 
omreninfp: penniform; 
wsbonliar: bronislaw; 
tqy: qty; 
jot: jot; ojt; 
oxr: xor; rox; 
tct: tct; ttc; ctt; 
chjo: joch; 
awrn: warn; wran; narw; 4;
mpramh: mpharm; pharmm; 0;
lruehv: hulver; 0;
asormdnhi: randomish; rhodamins; 0;
aculo: aluco; 0;
soabridm: ambroids; 1;
eocvilrnu: volucrine; involucre; 0;
agwesere: sewerage; 0;
utpstrsea: upstaters; 0;
umslcsyo: scolymus; 0;
arkmupce: cupmaker; 0;
mrubsho: rhombus; 0;
ipsnarci: priscian; 0;
uapelshr: spherula; 0;
nmoytibs: symbiont; 0;
oboelds: boodles; -1;
onesalt: etalons; tolanes; 0;
gdluate: ludgate; 0;
echamrdo: merodach; 0;
